     #               #
     #               ###################
     #       ####                     ##
     #                                 /
     #               ##########        #
     ##############  #        #        #
     #            #  #        #        #
     #               #        #        /
     #               #        #        /
     #       #      #######   #        #                              #
     #       #                #        #                              #
     ##  ###########################################################  #
     #                                                             #  #
     #                                                      ########  #
     #                              ################################  #
     ################################                                 #
     #################                 ################################
     #                                 #                              #
     #      ####     ###################                              #
     ########              #
     #
                     #          #       ###############################
     ########        ####################
     #                                  #
     #################################  ###############################